TOP SECRET
!!!
======


HESOYAM — все здоровье, броня и $250000 в кармане;

LXGIWYL — набор оружия №1;

KJKSZPJ — набор оружия №2;

UZUMYMW — набор оружия №3;

WANRLTW — полный боезапас;

NCSGDAG — мастерское владение оружием;

VQIMAHA — мастерское вождение;

JYSDSOD — Карл становится качком;

BTCDBCB — Карл-толстяк;

KVGYZQK — Карл-дистрофик;

OGXSDAG — максимальный уровень репутации;

EHIBXQS1 — сексуальная привлекательность на максимуме;

CVWKXAM — Карл забывает, что такое одышка;

SZCMAWO — самоубийство;

AEDUWNV — отсутствие потребности в еде;

LIYOAAY — slo-mo;

PPGWJHT — ускорение игрового процесса;

ASNAEB — снизить “интерес” полиции к Карлу;

OSRBLHH — повысить “интерес” полиции к Карлу;

LJSPQK — максимальное внимание к Карлу со стороны полиции;

AEZAKMI — полиции наплевать на все действия Карла;

BEKKNQV — все проститутки без ума от Карла;

OUIQDMW — стрельба из машины во время движения;

SJMAHPE — завербовать любого человека и вооружить его пистолетом;

ZSOXFSQ — то же самое, но вместо пистолета ракетница;

AJLOJYQY — жители города атакуют друг друга;

BGLUAWML — все пешеходы начинают нападать на Карла;

FOOOXFT — все жители получают оружие;

ASBHGRB — город заполняется клонами Элвиса;

AFZLLQLL — обычная погода;

AUIFRVQS — дождливая погода;

ICIKPYH — солнечная погода;

ALNSFMZO — облачно;

CFVFGMJ — туман;

CWJXUOC — песчаная буря;

OFVIAC —закат замирает на небе в 21:00;

XJVSNAJ — в городе всегда полночь;

AIYPWZQP — получить парашют;

KRIJEBR — получить Stretch;

JQNTDMH — получить Rancher;

CQZIJMB — получить Bloodring Banger;

PDNEJOH — получить Hotring Racer 1;

VPJTQWV — получить Hotring Racer 2;

UBHYZHQ — получить Trashmaster;

AIWPRTON — получить Rhino;

AQTBCODX — получить Romero Hearse;

RZHSUEW — получить Caddy;

YECGAA — получить реактивный ранец;

AGBDLCID — получить Monster Truck;

AKJJYGLC — получить велосипед;

JUMPJET — получить Hydra;

URKQSRK — получить Stunt Plane;

KGGGDKP — получить Hovercraft;

EEGCYXT — получить Dozer;

OHDUDE — получить Hunter;

AMOMHRER — получить Tanker;

CPKTNWT — все машины вокруг Карла взрываются;

IOWDLAC — все машины окрашиваются в черный цвет;

LLQPFBN — то же самое, только цвет розовый;

LFGMHAL — высокие прыжки;

YLTEICZ — агрессивные водители;

PGGOMOY — увеличить маневренность автомобилей;

XICWMD — невидимые машины (остаются только колеса);

ZEIIVG — на светофорах всегда зеленый свет;

GUSNHDE — по улицам разъезжают исключительно спортивные автомобили;

THGLOJ — уменьшает плотность машин на улицах;

VKYPQCF — апгрейд такси;

CIKGCGX — Beach Party Mode;

IOJUFZN — Yakuza Mode;

PRIEBJ — по улицам разгуливают клоуны;

BSXSGGC — при столкновении машины улетают в неизвестном направлении;

RIPAZHA — летающие машины;

AFSNMSMW — летающие лодки.

=======
!!!
END TOP SECRET
